# Joseph Zambreno
# Garret Meier
# Iowa State University
# roomDefault.zrf - template for making rooms.

# Center room, hard
.size 13 13
.tiles
 0  1  1  1  1  1 50  1  1  1  1  1  2
 6 20 20 20 20 20  7 20 20 20 20 20  8
 6 20  7  7  7  7  7  7  7  7  7 20  8
 6 20  7 20 20  7 20  7 20 20  7 20  8
 6 20  7 20  7 20  7  7  7 20  7 20  8
 6 20  7  7  7 20 102 20 20 7  7 20  8
50  7  7 20  7 102 13 102 7 20 7  7 50
 6 20  7  7 20 20 102 20 7  7  7 20  8
 6 20  7 20  7  7  7  20 7 20  7 20  8
 6 20  7 20 20  7 20  7 20 20  7 20  8
 6 20  7  7  7  7  7  7  7  7  7 20  8
 6 20 20 20 20 20  7 20 20 20 20 20  8
10 11 11 11 11 11 50 11 11 11 11 11 12
